%%%%%%%%%%
%        %
%        %
%        %
%  %  %  %
%  %  %  %
%        %
%        %
%        %
%%%%%%%%%%
