%%%%%%%%%%%%
%          %
%          %
%          %
%          %
%  %%  %%  %
%  %%  %%  %
%          %
%          %
%          %
%          %
%%%%%%%%%%%%